######## x
#  # #   #
##     # #
#  # # # #
# # ###  #
#    # # #
# # #    #
#  #  ## #
##  ##   #
# #   ## #
# ## #   #
#     ## #
o ########