################## x
# # # # # #    # # #
#       #  # # #   #
# ## ##   #   #  # #
# # ##  #### # ##  #
#     #   #      # #
# ### # # # # # #  #
# # ## #  #  ##  # #
#       #   #  #   #
# ## ## ##### # ####
# #  #             #
# # # #### ####### #
## ##     #        #
## # ## # # ## # # #
#     # # # ########
# # #   # #  # # # #
# # # # # ##       #
## ## ##   #### ## #
#  #    ##     ##  #
## #### #  # #   # #
#        #  #  #   #
o ##################