##########
#  # #   #
##     # #
#  # # # #
# # ###  #
#   x# # #
# # #    #
#  #  ## #
##  ##   #
# #   ## #
# ## #o  #
#     ## #
##########